200 3
1 8 15 17 18 21 34 36 38 41 42 53 55 63 69 70 75 77 78 81 89 97 99 100 101 102 109 114 116 118 123 125 126 127 128 132 133 143 145 152 161 162 163 168 172 175 180 184 186 187 195 196 197 199
2 4 5 10 19 20 22 23 24 25 28 29 32 33 37 40 48 49 52 56 58 61 62 65 67 68 79 80 83 85 86 87 90 94 103 106 111 115 121 122 130 131 135 138 140 142 149 151 153 156 159 160 165 166 169 170 173 182 183 185 189 194
3 6 7 9 11 12 13 14 16 26 27 30 31 35 39 43 44 45 46 47 50 51 54 57 59 60 64 66 71 72 73 74 76 82 84 88 91 92 93 95 96 98 104 105 107 108 110 112 113 117 119 120 124 129 134 136 137 139 141 144 146 147 148 150 154 155 157 158 164 167 171 174 176 177 178 179 181 188 190 191 192 193 198 200
356 369 400
7 5 2 5 2 3 4 1 8 2 2 6 4 7 7 3 6 6 3 9 4 7 3 1 10 1 9 5 4 8 10 9 6 7 5 7 10 10 9 7 9 4 3 5 3 6 10 8 6 7 7 9 4 6 8 2 6 5 8 10 3 7 7 9 4 10 9 1 3 8 1 4 5 2 5 2 1 3 4 9 1 10 5 2 5 3 6 7 8 2 5 7 8 3 9 10 10 8 4 9 5 4 3 7 8 8 8 6 4 10 2 5 5 5 4 8 3 3 2 7 9 8 6 4 9 1 6 4 4 6 3 10 9 10 8 4 1 1 10 2 1 4 4 6 8 2 8 4 6 7 10 9 7 6 2 8 9 1 2 8 3 9 5 2 10 9 8 4 8 7 8 2 8 10 8 10 9 7 5 7 8 3 2 3 3 7 9 9 2 5 2 5 1 3 2 4 6 10 2 1
1 2 3 4 5 6 7 8
9 10 11 2 12 13 14 15 16 17 18 19 20
21 22 23 24 25 26 27 28 29 30 31 32 33 34 35 36 37 38 39 40 41 42 43 44 45 46 47 48 49
50 51 52 53 54 55 31 56 57 35 58 59 60 61 62 63 64 65 66 67
52 27 59 62
68 69 70 71 72 73 74 75 76 77 78 4 79 80 81 82 83 84 85 86 87 88 89 90 91
92 93 94 95 32 96 97 98 99 100 101 102 103 104
95 105 81 106
107
108
109 110 111 112 113 114 115 116 117 118 71 119 120 121 122 123 124 125 126 127 128 129 130 131 132 133 134 135 136 137 138 139 140 141 142 143 144
145 12 146 147 148
149 150 151 152 153 154 155 156 157 158 159 160 161 162 163 164 165 166
167 158
168 169 170 171 172 173 3 174 175 176 177 178 179
180
170 171 172 174 175 181 182 180 183 184 42 185 186
187 188 189 190 191 192 193 194 195 196 197 198 199 200 201 202 203 204 205 206 207 208 36 209 210 211 212 213 214 215 216 217 218
219 220 193 221 222 223 36 224
187 21 225 220 226 52 227 228 229 230 231 232 209 212 233 214 44 45
234 235
236 237 238 239 240 235
241 242 243 244 245 246 73 74 123 247 176 248 249 250 251 252 253 254 255 256 257 90
241 243 258 73 74 176 259 248 250 251 253 255 256
242 258 73 74 176 248 250 251 253 255 256 257
260 261 262 263 242 264 243 265 266 267 268 269 270 271 272 258 273 274 74 275 276 75 277 77 78 176 278 279 280 281 282 283 284 248 250 285 286 159 287 81 288 251 289 290 253 291 100 17 83 292 293 84 294 295 101 296 297 298 85 103 255 299 300 301 256 302 303 304
68 69 242 305 243 244 71 258 306 73 307 308 176 248 250 148 309 251 310 311 253 17 312 313 255 301 256 314 315 316 317
242 243 258 73 74 248 250 180 251 253 255 256
242 243 258 73 74 176 318 248 251 253 100 296 255 256
242 319 243 320 258 73 74 176 248 250 321 322 253 323 324 255 256
242 243 244 320 325 258 326 73 74 327 176 328 329 330 248 250 331 251 252 332 323 333 255 256 314 334 48
242 243 258 73 74 176 248 250 251 253 256
242 243 244 335 71 258 73 74 336 337 338 307 176 339 340 248 341 342 250 343 344 251 345 346 253 323 255 347 348 349
242 243 258 73 74 176 250 251 253 255 256
350 351 352 353 354 355 356 357 358 359 360
361 362 363 350 352 364 365 366 367 368 369 370 354 207 371 372 373 374 375 358 376 359
377 27 54 35 378
379 380 156 381 160 106 382 383
384
385 386 387 388 389 390 391
392 393 394 395 396 123 397 398 12 399 400 401 346 402 403 404 405 406
385 407 408 409 410 411 398 412 389 413 414 415 416
417
418 419 420 421 422 423 424 425 426 427 428 429 430 431 376 432 433
434 435
436
437 152 438 439 413 440 441 442 443
437 152 438 444 439 413 440 445 441 446
149 444 167 157 162 441 163 443
437 152 444 447 440 448 443 449
450 451 452 453
454 455 456 457 458 459 460 461 462 463 464 465 466 451 452 467 453 468 469 470 471 472 473 474 475 476 477 478
460 450 452 453
455 457 459 460 450 479 480 464 465 481 451 453 468 482 374 474 476
460 450 451 452 483
484 485
484 486 487 488 489 413 148 490 160 491 492
493 244 494 70 71 72 74 76 495 365 80 309 17 87 88 90 91
68 69 496 497 494 325 71 245 258 326 74 498 499 307 495 500 501 329 280 502 503 309 504 16 505 506 252 253 507 508 41 509 254 510 511 256 512 49
513 69 514 515 516 517 244 326 396 309 518 519 520 143 521
69 305 522 517 244 326 74 523 495 249 252 312 524 102 301 317
116 71 127 147
260 261 525 526 262 263 527 528 264 529 530 265 531 532 266 267 533 268 534 270 271 272 535 536 274 73 92 275 276 93 537 277 538 154 78 539 105 278 279 280 281 540 283 284 541 542 285 286 159 97 287 543 289 290 544 545 82 546 291 100 292 293 294 295 296 297 298 547 102 103 300 548 301 549 104 550 302 551 552 303 304
260 525 526 262 263 528 264 530 265 266 267 533 553 268 554 555 270 272 535 274 73 92 275 276 93 277 538 78 105 278 279 280 281 540 283 284 556 557 541 342 285 286 159 97 287 289 290 82 546 291 558 100 292 293 294 295 101 296 559 297 298 102 560 561 300 562 301 104 563 550 302 551 48 303 564 304 565
103 565
525 526 527 529 266 534 536 92 537 154 540 542 566 286 543 289 545 101 102 103 548 549 104 302
533
117 567 12 147 568
569 570 571 572 573 411 387 54 397 145 127 574 575 4 576 577 400 578 401 148 16 402 139 579 580 390 581 301 582 213 583 584 585 586
587
588 589 590 128 16 591 592 593
594 595 56 130 147 596
597 594 598 113 27 599 596
600 601 602 603 604 605 606 148 6 607 546 608
260 526 241 263 600 527 602 266 534 609 603 610 604 611 276 605 537 78 612 613 259 280 283 606 614 542 148 615 159 616 617 618 619 6 82 620 621 622 623 101 297 103 624 303
625 626 627
628 629 630 626 627 233
630 625 627
631 632 630 625 396 626 633 634 635 636 469
637
638
639
640
641
642
643 146 378 644 645
146 646 647
648 262 487 649 650 651 652 653 654 655
385 656 657 658 659 660 661 662 663 664 665 666 667 668
423 426 417
422 426 417
422 423 417
444 669 413 161 442 443 670 671 334 304
672 673 439 674 304
260 261 262 263 264 265 266 111 267 268 270 675 271 272 274 73 275 276 277 439 78 676 669 278 279 280 281 677 283 284 285 286 159 287 289 290 291 100 292 293 294 295 101 296 297 298 103 300 301 302 303
68 264 678 496 244 679 71 245 326 74 680 498 681 154 500 502 682 683 503 252 507 508 100 41 509 296 684 256 685 512 49
686 307 685
307 682
113 147
69 244 687
688 226 24 689 690 350 691 230 692 693 694 36 695 696 697 698 699 44
700 226 229 694 701 36 702 703 704 44
705 706 54 707 708 709 710 711 712 713 714 715
716 717 718 719 713
717 709
720 721 722 723 724 725 726 727 728
729 720 730 723 731 732 733 734 735
260 261 262 263 264 265 266 267 268 736 270 271 272 274 73 275 276 277 78 279 280 281 283 284 285 286 159 287 289 290 737 291 100 292 293 294 295 101 296 297 298 103 300 301 302 48 303 49 304
23 52 32 278 330 738 253 739 559 333 233 103 561 104 551 49
68 496 23 244 71 245 52 326 498 307 32 500 278 740 502 503 252 507 508 41 509 512 48
525 244 741 742 743 744 745 746 747 748 749 750 751 752 753 510 754 755 756 757
244 758 505 163 644
759 760 761 762 763 764 765 758 766 767 768 769 770 771 772
773
774 239 775 776 777 778 779 780 781 782 783 784 785 786
787 782
787 777 778 779 785
708
363 788 350 717 789 790 791 792 793 794
795 773 796 758 766 797 542 798 161 799 800 801 802
803 797 767 583
804
805
806 527 266 533 534 807 808 613 501 809 767 810 82 546 811 101 548
812 813 809 542 814 815 816 817 818 819
68 820 821 229 230 822 823 824 36 233 825 44
21 628 226 826 629 827 625 828 36 829 48 830
831 31
656 832 50 833 834 835 836 52 27 831 837 55 838 34 37 839 40 60 63 65 66 840 47 841
73
842 843 844 425 845 417
806 527 266 533 276 846 613 501 280 542 546 621 101 548 303 847
848 849
850 851 852 853 572 854 855 856 146 148 857 160 858 859 860 754 861 862 89 492 849
863 864 859 865 848 861 866
867 868 869 12 870 413 871 666 872 139 714
150 444 388 485 145 439 871 148 873 163 442 443 874
145 413
875 71 79 677 876 147 148 877 304
878 236 879 880
881 234 882 883 879 239 884 885 240 886 887 880
363 881 888 883 236 518 889 890
891
892
893
894 895 896 897 898 899
534 808 900 901 542 902 810 903
806 542
394 904 905 906 162 907 908 909 910
911 912 162
149 911 151 152 153 167 157 906 161 163
913
914 365 915 916 917 918 919 920 921 922 923 924
365 823 918
69 925 867 926 927 928 929 930 931 932 933 934 913 935 353 231 823 936 694 16 918 937 938 939 712 940 941 942 214 943
226 926 944 365 915 918 44
24 926 930 365 915 913 945 823 921 943
946 826 377 947 717 119 27 571 572 411 394 387 948 12 949 950 883 399 951 231 665 135 952 953 954 955 62 956 957 582 958 959
54
960 961 962 963 505 964 753 965 966 967 968 969
970 419 971 962 972 973 974 505 749 975
976 977 978 979 980 981 982 983 984 975 966 985 969
980 986 985
987 988 989 990 978 991 992 986 981 982 984 993 994
995 996 114 119 745 997 998 147 999 1000 1001
1002 1003 119 760 122 124 745 998 999 1004 1005 1006 1007 1000 1008
119 396 1009 1010 1011 1012 997 1013 1014 1015 143 1016 1017 1018
1019 1002 1020 1021 1011 1022 1012 1023 1024 1014 1025 1026 1027 1028 1029
1002 1010
1030 1031 1032 1033 1034 1035 1036 1037 1038 1039 1040 1041
1030 1033 1042
657 1043 55 31 838 1044 651 63 1045 840 841
656 114 27 55 31 841
1046 656 1047 1043 1048 31 1044 1049 63 1045
150 773 759 1050 1051 13 1052 873 767 1053 163 1054 768 644 1055 510 770 1056 772 1057
392 515 393 1002 631 1058 1059 397 1060 495 809 400 746 635 636 666 1061 1062 627 143 390 299 404 1063 1017
658 659 396 1064 145 870 1065 1066 651 544
350 353 370 344 323 347 359
10 4
149 150 152 167 758 157 413 162 510 1057 874
513 1067 1068 1069 1070 119 1071 1072 745 1073 1074 606 1075 148 1076 1077 1078 1079 754 1080 1081 1082 89 1083 1084
1085 1086 75 1087 96 98 1088 1089 1082
1085 1090 1091 686 1092 1093 1094 1095 1096 1097 1098 1037 1099 40 1100 1080 1101
650 660 1012 1102 652 1103
649
1104 1105 1106 758 1107 1108 1109 1110 1111 1112 1113 163 18 1114 1115
1116 1117 17 89
1117 86
1118 1119 1076 1120 1121 1122 984 579 1123 1124
1125 1126 1127 1128 1129 1119 1130 1076 1131 1120 1121 1122 984 1132 579 1123 1124
1125 1118 1133 1134 1135 1128 369 1076 1122
1085 1125 1118 606 1075 148 1119 1122 1136 1081
1125 1118 1137 1138 1119 1076
1139 149 9 1140 1141 1142 1143 1144 1145 1146 12 576 146 1147 1148 213
570
1149 643 1150 1151 1152 207 1153 1154 41
1155
1156 1157 1158 1159 1160 137 1161
1162 1156 1133 1157 1163 1159 1160 137 1164 1161
1165 1156 1166 1167 1163 1158 1168 1169 1170 1171
100